G                      GGG                         G,
G                                                  G,
G        GLLLG        G                            G,
G        GGGGGGG   P G                             G,
G                                                  G,
G               G GGG                              G,
G             G          G                         G,
G              G                                   G,
GWWWWWWWWWWWWWWWWWWWWWWWWWWWWWWWWWWWWWWWWWWWWWWWWWWG,
GGGGGGGGGGGGGGGGGGGGGGGGGGGGGGGGGGGGGGGGGGGGGGGGGGGG,